


labelNewUser = Новый пользователь

menuFile = Файл
menuNewUser = Новый пользователь
menuOpenFile = Открыть файл
menuSave = Сохранить
menuSetting = Настройки
		
menuCategory = Категории
menuCurrency = Валюты
menuLanguage = Изменить язык

menuPasteCaption = Vlo\u017Eit
		
mainHi = Привет
mainBalance = Баланс
mainActual = Актаульные
mainPlanning = Планированные
mainInTotal = Результат
mainExpenses = Расходы
mainIncome = Доходы

toolAccountAdd = Добавить новый счет
toolAccountRemove = Удалить счет
toolAccountClear = Сняьб выбор счета
toolOperAdd = Добавить новую операцию
toolOperEdit = Редактировать операцию
toolOperTransfer = Трансфер между счетами
toolOperRemove = Удалить операцию

tableForSelectSum = Сумма выбранных операций:
tableStatus = Статус
tableDate = Дата
tableSum = Сумма
tableCategory = Категория
tableSubCategoty = Подкатегория
tableContragent = Контрагент
tableNote = Пометка

categoryAddNew = Добавить новую категорию
categoryAddNewSub = Добавить новую подкатегорию

currencyName = Имя
currencySymbol = Символ
currencyRate = Курс

createAccountName = Имя нового счета
createAccountCurrency = Валюта
createAccountSum = Начальная сумма

createOpearionAccountName = Счет
createOpearionAccountType = Тип операции 
createOpearionAccountTotal = Сумма
createOpearionAccountCurrency = Валюта
createOpearionAccountDate = Дата
createOpearionAccountCategory = Категория
createOpearionAccountSubCategory = Подкатегория
createOpearionAccountContragent = Контрагент
createOpearionAccountNote = Пометка
createOpearionAccountPlan = Сохранить как планированную операцию

transfer1Account = Начальный счет
transfer2Account = Конечный счет
transferSum = Сумма
transferTotal = Конечная сумма


buttonSave = Сохранить
buttonClose = Закрыть